3 3 3 3 3 3 3 3 3 3 3 3 3 3 3 3 3 3 3 3 3 3 3 3 3 3 3 3 3 3 3 3 3 3 3 3 3 3 3 3 3 3 3 3 3 3 3 3 3 3 
5 5 5 5 5 5 5 5 5 5 5 5 5 5 5 5 5 5 5 5 5 5 5 5 5 5 5 5 5 5 5 5 5 5 5 5 5 5 5 5 5 5 5 5 5 5 5 5 5 5
3 3 3 3 3 3 3 3 3 3 3 3 3 3 3 3 3 3 3 3 3 3 3 3 3 3 3 3 3 3 3 3 3 3 3 3 3 3 3 3 3 3 3 3 3 3 3 3 3 3 
5 5 5 5 5 5 5 5 5 5 5 5 5 5 5 5 5 5 5 5 5 5 5 5 5 5 5 5 5 5 5 5 5 5 5 5 5 5 5 5 5 5 5 5 5 5 5 5 5 5
3 3 3 3 3 3 3 3 3 3 3 3 3 3 3 3 3 3 3 3 3 3 3 3 3 3 3 3 3 3 3 3 3 3 3 3 3 3 3 3 3 3 3 3 3 3 3 3 3 3 
5 5 5 5 5 5 5 5 5 5 5 5 5 5 5 5 5 5 5 5 5 5 5 5 5 5 5 5 5 5 5 5 5 5 5 5 5 5 5 5 5 5 5 5 5 5 5 5 5 5 
6 3 6 3 6 3 6 3 3 3 3 3 3 3 3 3 3 3 3 3 3 3 3 3 3 3 3 3 3 3 3 3 3 3 3 3 3 3 3 3 3 3 3 6 3 6 3 6 3 6 
6 3 6 3 6 3 6 3 4 4 4 4 4 4 4 4 4 4 4 4 4 4 4 4 4 4 4 4 4 4 4 4 4 4 4 4 4 4 4 4 4 4 3 6 3 6 3 6 3 6 
6 3 6 3 6 3 6 3 4 4 4 4 4 4 4 4 4 4 4 4 4 1 1 1 1 1 1 1 1 1 1 1 1 1 4 4 4 4 4 4 4 4 3 6 3 6 3 6 3 6 
6 3 6 3 6 3 6 3 4 4 4 4 4 2 4 4 4 4 4 4 4 1 1 1 1 1 1 1 1 1 1 1 1 1 4 4 4 4 4 4 4 4 3 6 3 6 3 6 3 6 
6 3 6 3 6 3 6 3 4 4 4 4 4 4 4 4 4 4 4 4 4 4 4 4 4 4 4 4 4 4 4 4 4 4 4 4 2 4 4 4 4 4 3 6 3 6 3 6 3 6 
6 3 6 3 6 3 6 3 4 4 4 2 4 4 4 4 4 4 4 4 4 2 4 4 4 4 4 4 4 4 4 4 4 4 4 4 1 1 1 4 4 4 3 6 3 6 3 6 3 6 
6 3 6 3 6 3 6 3 4 4 4 4 4 4 4 4 4 4 4 4 4 4 4 4 4 4 4 4 4 4 4 4 4 4 4 4 1 1 1 4 4 4 3 6 3 6 3 6 3 6 
6 3 6 3 6 3 6 3 4 4 4 4 4 4 2 4 4 4 4 4 4 4 4 4 4 4 4 4 4 4 4 4 4 4 4 4 1 1 1 4 4 4 3 6 3 6 3 6 3 6 
6 3 6 3 6 3 6 3 4 4 2 4 4 4 4 4 4 4 4 4 4 4 4 4 4 4 4 4 4 4 4 4 4 4 4 4 4 2 4 4 4 4 3 6 3 6 3 6 3 6 
6 3 6 3 6 3 6 3 4 4 4 4 4 4 4 4 2 4 4 4 4 4 4 4 4 4 4 4 4 4 4 4 4 4 4 4 4 4 4 4 4 4 3 6 3 6 3 6 3 6 
6 3 6 3 6 3 6 3 4 4 4 4 4 4 4 4 4 4 4 4 4 4 4 4 4 4 4 4 4 4 4 4 4 4 4 4 2 4 4 4 4 4 3 6 3 6 3 6 3 6 
6 3 6 3 6 3 6 3 4 4 4 2 4 4 4 4 4 4 4 4 4 4 4 4 4 4 2 4 4 4 4 4 4 2 4 4 4 4 4 4 4 4 3 6 3 6 3 6 3 6 
6 3 6 3 6 3 6 3 4 4 4 4 4 4 2 4 1 1 1 1 4 4 4 4 4 4 4 4 4 4 4 4 4 4 4 4 4 4 4 4 2 4 3 6 3 6 3 6 3 6 
6 3 6 3 6 3 6 3 4 4 4 4 4 4 4 4 1 1 1 1 4 4 4 4 4 4 4 4 4 4 4 4 4 2 4 4 2 4 4 4 4 4 3 6 3 6 3 6 3 6 
6 3 6 3 6 3 6 3 4 4 4 4 4 4 2 4 4 4 4 4 4 2 4 4 4 4 4 4 4 4 4 4 4 4 4 4 4 4 4 4 4 4 3 6 3 6 3 6 3 6 
6 3 6 3 6 3 6 3 4 4 4 4 4 4 4 4 4 4 4 4 4 4 4 4 4 4 4 4 4 2 4 4 4 4 4 2 4 4 4 4 4 4 3 6 3 6 3 6 3 6 
6 3 6 3 6 3 6 3 4 4 2 4 4 4 4 4 4 4 4 4 4 4 2 4 4 4 4 4 4 4 4 4 2 4 4 4 4 4 4 4 4 4 3 6 3 6 3 6 3 6 
6 3 6 3 6 3 6 3 4 4 4 4 4 4 4 4 4 2 4 4 4 2 4 4 4 4 4 4 2 4 4 4 4 2 4 4 4 4 4 4 2 4 3 6 3 6 3 6 3 6 
6 3 6 3 6 3 6 3 4 4 4 4 4 4 2 4 4 4 4 4 4 2 4 4 4 4 4 4 4 2 4 4 4 4 4 4 4 4 4 4 4 4 3 6 3 6 3 6 3 6 
6 3 6 3 6 3 6 3 4 2 4 4 4 4 4 4 4 4 4 4 4 2 4 4 4 4 4 4 4 4 2 4 4 4 4 4 4 4 4 2 4 4 3 6 3 6 3 6 3 6 
6 3 6 3 6 3 6 3 4 4 4 4 4 4 4 2 4 4 4 4 2 4 4 4 4 4 4 4 4 4 1 1 1 1 4 4 4 4 4 4 4 4 3 6 3 6 3 6 3 6 
6 3 6 3 6 3 6 3 4 4 2 4 4 2 4 4 4 4 4 4 4 4 4 4 4 4 4 4 2 4 1 1 1 1 4 4 4 2 4 4 4 4 3 6 3 6 3 6 3 6 
6 3 6 3 6 3 6 3 4 4 4 4 4 4 2 4 4 2 4 4 4 4 4 4 4 4 4 4 4 4 4 4 2 4 4 4 4 4 4 4 4 4 3 6 3 6 3 6 3 6  
6 3 6 3 6 3 6 3 4 4 4 4 4 4 4 1 1 1 4 4 4 4 4 4 4 4 4 4 4 4 4 4 4 4 4 4 4 4 4 4 4 4 3 6 3 6 3 6 3 6 
6 3 6 3 6 3 6 3 4 4 4 4 4 4 2 1 1 1 4 2 4 2 4 4 4 4 4 4 4 4 2 4 4 4 4 4 4 2 4 4 4 4 3 6 3 6 3 6 3 6 
6 3 6 3 6 3 6 3 4 4 4 4 2 4 4 1 1 1 4 4 4 4 4 2 4 4 4 4 4 4 4 4 4 4 2 4 4 4 4 4 4 4 3 6 3 6 3 6 3 6 
6 3 6 3 6 3 6 3 4 4 4 4 4 4 4 4 4 4 4 4 4 4 4 4 4 4 4 4 4 4 2 4 4 4 4 4 4 4 4 4 4 4 3 6 3 6 3 6 3 6 
6 3 6 3 6 3 6 3 4 4 4 4 4 4 4 4 4 4 4 4 4 4 4 4 4 2 4 4 4 4 4 4 4 4 2 4 4 2 4 4 4 4 3 6 3 6 3 6 3 6 
6 3 6 3 6 3 6 3 4 4 4 4 4 4 4 4 4 4 4 4 2 4 2 4 4 4 4 4 2 4 4 4 4 4 4 4 4 4 4 4 4 2 3 6 3 6 3 6 3 6 
6 3 6 3 6 3 6 3 4 2 4 4 2 4 4 4 4 4 4 4 4 4 4 4 4 4 2 4 4 4 4 4 2 4 4 4 4 4 4 4 4 4 3 6 3 6 3 6 3 6 
6 3 6 3 6 3 6 3 4 4 4 4 4 4 4 4 4 2 4 4 4 4 4 4 4 4 4 4 4 4 4 4 4 4 4 4 4 4 4 4 4 4 3 6 3 6 3 6 3 6 
6 3 6 3 6 3 6 3 4 2 4 4 4 4 4 4 4 4 4 4 4 4 4 4 4 2 4 4 4 4 4 4 4 4 4 4 2 4 4 4 4 4 3 6 3 6 3 6 3 6 
6 3 6 3 6 3 6 3 4 4 4 4 4 2 4 4 4 4 4 4 4 4 4 4 4 4 4 4 4 4 4 4 4 4 4 4 4 4 4 4 4 4 3 6 3 6 3 6 3 6 
6 3 6 3 6 3 6 3 4 4 4 4 4 1 1 1 1 1 4 4 4 4 4 4 4 4 4 4 1 1 1 1 1 1 4 4 4 4 4 4 4 4 3 6 3 6 3 6 3 6 
6 3 6 3 6 3 6 3 4 4 4 4 4 1 1 1 1 1 4 4 4 4 4 4 4 4 4 4 1 1 1 1 1 1 2 4 4 2 4 4 4 4 3 6 3 6 3 6 3 6 
6 3 6 3 6 3 6 3 4 2 4 4 4 4 4 2 4 4 4 4 4 2 4 4 4 4 4 4 4 4 4 4 4 4 4 4 4 4 4 4 2 4 3 6 3 6 3 6 3 6 
6 3 6 3 6 3 6 3 3 3 3 3 3 3 3 3 3 3 3 3 3 3 3 3 3 3 3 3 3 3 3 3 3 3 3 3 3 3 3 3 3 3 3 6 3 6 3 6 3 6 
5 5 5 5 5 5 5 5 5 5 5 5 5 5 5 5 5 5 5 5 5 5 5 5 5 5 5 5 5 5 5 5 5 5 5 5 5 5 5 5 5 5 5 5 5 5 5 5 5 5
3 3 3 3 3 3 3 3 3 3 3 3 3 3 3 3 3 3 3 3 3 3 3 3 3 3 3 3 3 3 3 3 3 3 3 3 3 3 3 3 3 3 3 3 3 3 3 3 3 3 
5 5 5 5 5 5 5 5 5 5 5 5 5 5 5 5 5 5 5 5 5 5 5 5 5 5 5 5 5 5 5 5 5 5 5 5 5 5 5 5 5 5 5 5 5 5 5 5 5 5 
3 3 3 3 3 3 3 3 3 3 3 3 3 3 3 3 3 3 3 3 3 3 3 3 3 3 3 3 3 3 3 3 3 3 3 3 3 3 3 3 3 3 3 3 3 3 3 3 3 3 
5 5 5 5 5 5 5 5 5 5 5 5 5 5 5 5 5 5 5 5 5 5 5 5 5 5 5 5 5 5 5 5 5 5 5 5 5 5 5 5 5 5 5 5 5 5 5 5 5 5 
3 3 3 3 3 3 3 3 3 3 3 3 3 3 3 3 3 3 3 3 3 3 3 3 3 3 3 3 3 3 3 3 3 3 3 3 3 3 3 3 3 3 3 3 3 3 3 3 3 3